See UCI HAR Dataset\features.txt for explanation of the aquisition of the data

Variables:

volunteer = Number identifier for each of the 30 volunteers
activity = Name of activity being performed

Below variables are normalized and bounded within [-1,1]:

tBodyAcc-mean()-X = mean of body acceleration signal in X direction (time domain)                  
tBodyAcc-mean()-Y = mean of body acceleration signal in Y direction (time domain)              
tBodyAcc-mean()-Z = mean of body acceleration signal in Z direction (time domain)                  
tBodyAcc-std()-X = standard deviation of body acceleration signal in X direction (time domain)                 
tBodyAcc-std()-Y = standard deviation of body acceleration signal in Y direction (time domain)                 
tBodyAcc-std()-Z = standard deviation of body acceleration signal in Z direction (time domain)                
tGravityAcc-mean()-X = mean of gravity acceleration signal in X direction (time domain)              
tGravityAcc-mean()-Y = mean of gravity acceleration signal in Y direction (time domain)             
tGravityAcc-mean()-Z = mean of gravity acceleration signal in Z direction (time domain)              
tGravityAcc-std()-X = standard deviation of gravity acceleration signal in X direction (time domain)              
tGravityAcc-std()-Y = standard deviation of gravity acceleration signal in Y direction (time domain)               
tGravityAcc-std()-Z = standard deviation of gravity acceleration signal in Z direction (time domain)              
tBodyAccJerk-mean()-X = mean of acceleration jerk signal in X direction (time domain)             
tBodyAccJerk-mean()-Y = mean of acceleration jerk signal in Y direction (time domain)           
tBodyAccJerk-mean()-Z = mean of acceleration jerk signal in ZX direction (time domain)            
tBodyAccJerk-std()-X = standard deviation of acceleration jerk signal in X direction (time domain)            
tBodyAccJerk-std()-Y = standard deviation of acceleration jerk signal in Y direction (time domain)             
tBodyAccJerk-std()-Z = standard deviation of acceleration jerk signal in Z direction (time domain)            
tBodyGyro-mean()-X = mean of body angular velocity signal in X direction (time domain)               
tBodyGyro-mean()-Y = mean of body angular velocity signal in Y direction (time domain)               
tBodyGyro-mean()-Z = mean of body angular velocity signal in Z direction (time domain)                
tBodyGyro-std()-X = standard deviation of body angular velocity signal in X direction (time domain)               
tBodyGyro-std()-Y = standard deviation of body angular velocity signal in Y direction (time domain)                
tBodyGyro-std()-Z = standard deviation of body angular velocity signal in Z direction (time domain)               
tBodyGyroJerk-mean()-X = mean of angular velocity jerk signal in X direction (time domain)               
tBodyGyroJerk-mean()-Y = mean of angular velocity jerk signal in Y direction (time domain)          
tBodyGyroJerk-mean()-Z = mean of angular velocity jerk signal in Z direction (time domain)           
tBodyGyroJerk-std()-X = standard deviation of angular velocity jerk signal in X direction (time domain)           
tBodyGyroJerk-std()-Y = standard deviation of angular velocity jerk signal in Y direction (time domain)            
tBodyGyroJerk-std()-Z = standard deviation of angular velocity jerk signal in Z direction (time domain)           
tBodyAccMag-mean() = mean of the 3 dimensional magnitude of the body acceleration (time domain)              
tBodyAccMag-std() = standard deviation of the 3 dimensional magnitude of the body acceleration (time domain)                 
tGravityAccMag-mean() = mean of the 3 dimensional magnitude of the graviational acceleration (time domain)              
tGravityAccMag-std() = standard deviation of the the 3 dimensional magnitude of the graviational acceleration (time domain)            
tBodyAccJerkMag-mean() = mean of the 3 dimensional magnitude of the body acceleration jerk signal (time domain)          
tBodyAccJerkMag-std() = standard deviation of the 3 dimensional magnitude of the body acceleration jerk signal (time domain)            
tBodyGyroMag-mean() = mean of the 3 dimensional magnitude of the body angular velocity (time domain)               
tBodyGyroMag-std() = standard deviation of the 3 dimensional magnitude of the body angular velocity (time domain)              
tBodyGyroJerkMag-mean() = mean of the 3 dimensional magnitude of the body angular velocity jerk signal (time domain)           
tBodyGyroJerkMag-std() = standard deviation of the 3 dimensional magnitude of the body angular velocity jerk signal (time domain)          
fBodyAcc-mean()-X = mean of body acceleration signal in X direction (frequency domain)                 
fBodyAcc-mean()-Y = mean of body acceleration signal in Y direction (frequency domain)               
fBodyAcc-mean()-Z = mean of body acceleration signal in Z direction (frequency domain)                
fBodyAcc-std()-X = standard deviation of body acceleration signal in X direction (frequency domain)                
fBodyAcc-std()-Y = standard deviation of body acceleration signal in Y direction (frequency domain)                  
fBodyAcc-std()-Z = standard deviation of body acceleration signal in Z direction (frequency domain)               
fBodyAcc-meanFreq()-X = mean frequency of gravity acceleration signal in X direction (frequency domain)             
fBodyAcc-meanFreq()-Y = mean frequency of gravity acceleration signal in Y direction (frequency domain)            
fBodyAcc-meanFreq()-Z = mean frequency of gravity acceleration signal in Z direction (frequency domain)             
fBodyAccJerk-mean()-X = mean of acceleration jerk signal in X direction (frequency domain)           
fBodyAccJerk-mean()-Y = mean of acceleration jerk signal in Y direction (frequency domain)             
fBodyAccJerk-mean()-Z = mean of acceleration jerk signal in Z direction (frequency domain)            
fBodyAccJerk-std()-X = standard deviation of acceleration jerk signal in X direction (frequency domain)             
fBodyAccJerk-std()-Y = standard deviation of acceleration jerk signal in X direction (frequency domain)            
fBodyAccJerk-std()-Z = standard deviation of acceleration jerk signal in X direction (frequency domain)             
fBodyAccJerk-meanFreq()-X = mean frequency of acceleration jerk signal in X direction (frequency domain)         
fBodyAccJerk-meanFreq()-Y = mean frequency of acceleration jerk signal in Y direction (frequency domain)        
fBodyAccJerk-meanFreq()-Z = mean frequency of acceleration jerk signal in Z direction (frequency domain)       
fBodyGyro-mean()-X = mean of body angular velocity signal in X direction (frequency domain)              
fBodyGyro-mean()-Y = mean of body angular velocity signal in Y direction (frequency domain)               
fBodyGyro-mean()-Z = mean of body angular velocity signal in Z direction (frequency domain)                
fBodyGyro-std()-X = standard deviation of body angular velocity signal in X direction (frequency domain)              
fBodyGyro-std()-Y = standard deviation of body angular velocity signal in Y direction (frequency domain)               
fBodyGyro-std()-Z = standard deviation of body angular velocity signal in Z direction (frequency domain)              
fBodyGyro-meanFreq()-X = mean frequency of angular velocity signal in X direction (frequency domain)          
fBodyGyro-meanFreq()-Y = mean frequency of angular velocity signal in Y direction (frequency domain)          
fBodyGyro-meanFreq()-Z = mean frequency of angular velocity signal in Z direction (frequency domain)           
fBodyAccMag-mean() = mean of the 3 dimensional magnitude of the body acceleration (frequency domain)             
fBodyAccMag-std() = standard deviation of the 3 dimensional magnitude of the body acceleration (frequency domain)                  
fBodyAccMag-meanFreq() = mean frequency of the 3 dimensional magnitude of the body acceleration (frequency domain)              
fBodyBodyAccJerkMag-mean() = mean of the 3 dimensional magnitude of the body acceleration jerk signal (frequency domain)      
fBodyBodyAccJerkMag-std() = standard deviation of the 3 dimensional magnitude of the body acceleration jerk signal (frequency domain)       
fBodyBodyAccJerkMag-meanFreq() = mean frequency of the 3 dimensional magnitude of the body acceleration jerk signal (frequency domain)  
fBodyBodyGyroMag-mean() = mean of the 3 dimensional magnitude of the body angular velocity (frequency domain)           
fBodyBodyGyroMag-std() = standard deviation of the 3 dimensional magnitude of the body angular velocity (frequency domain)            
fBodyBodyGyroMag-meanFreq() = mean frequency of the 3 dimensional magnitude of the body angular velocity (frequency domain)    
fBodyBodyGyroJerkMag-mean() = mean of the 3 dimensional magnitude of the body angular velocity jerk signal (frequency domain)     
fBodyBodyGyroJerkMag-std() = standard deviation of the 3 dimensional magnitude of the body angular velocity jerk signal (frequency domain)       
fBodyBodyGyroJerkMag-meanFreq() = mean frequency of the 3 dimensional magnitude of the body angular velocity jerk signal (frequency domain)  